# # # # # # # # # # # # # # # 
# . . # . # . # # # # . . # # 
# # # # # # . # . . . # . . # 
# # # . . # . # # # . # . # # 
# # . # # . # # . # . . # # # 
# . # # . # . . # . # # . # # 
# # . . # # . # . . . . # . # 
# . # # . # . # . . . . . . # 
# . # . # . . # . # . # . # # 
# . . . # . . # # # # . . . # 
# # . # . . . . . # # . # # # 
# # . # . . # . # . . . . # # 
# . . . . # # # . # # . # . # 
# . . . . # # # . # # # . # # 
# . . . # # . # . # . # . . # 
# . . # # . # # # . # . . . # 
# . # # # . . # . # . . # # # 
# # # . # # # # . . # # # # # 
# . . # . . . # # # . # # # # 
# # # . # . . . . . . # . # # 
# # . # . # . . # . . . . # # 
# . . # . . # . # . . . . . # 
# . # . . # # . . # # # . . # 
# . # . # # . . . # # # # . # 
# # . . . # # # . . # # # # # 
# # . # # . . # . . # . # # # 
# # . . # . # # # . . . # # # 
# . # . # . # # . . . # . . # 
# . . # # # # # # # # . # . # 
# # # # # # # # # # # # # # # 

# # # # # # # # # # # # # # # 
# # # # # # # # # # # # # # # 
# # # # # . # # # # # . . # # 
# # # # # # # # # . . . # # # 
# # # # # . # # # # # . # # # 
# # # # # # # . . . . . # # # 
# # # # # . # . . . . . . # # 
# # . # # . # . . . . . . # # 
# # . # . . . . # . . . . . # 
# # . . . . . . # # # . . # # 
# # . . . . . . # # . . . # # 
# # . . . . . . . # . . . # # 
# . . . . # # # # # # . . # # 
# . . . . # # # # # # # . # # 
# . . . # # # # # # # . . . # 
# . . # # # # # # . . . . # # 
# # # # # # # # # . . # # # # 
# # # # # . # # # . # # # # # 
# # # # . . . . . . # # # # # 
# # # . . . . . . . . . # # # 
# # # . . . . . . . . . . # # 
# # . . . . . . . . . . . . # 
# # . . . # . . . # # # . . # 
# # . . . # # . . # # # # # # 
# # . . # # # . . . # # # # # 
# # . . . # # # . . . # # # # 
# # . # . # # # . . . . # # # 
# # . # # # # # # . . . . # # 
# # # # # # # # # # # # # # # 
# # # # # # # # # # # # # # # 

# # # # # # # # # # # # # # # 
# # # # # # # # # # # # # # # 
# # # # # # # # # # # # # # # 
# # # # # # # # # # . . # # # 
# # # # # # # # # . . . # # # 
# # # # # # # # . . . . # # # 
# # # # # # . . . . . . . # # 
# # # # # . . . . . . . . # # 
# # # . . . . . . . . . . # # 
# # . . . . . . # # . . . # # 
# # . . . . . . # # . . . # # 
# # . . . . . . # # . . . # # 
# . . . . . # # # # # . . # # 
# . . . . # # # # # # . . # # 
# . . . # # # # # # # . . # # 
# # . # # # # # # # . . . # # 
# # # # # # # # # . . # # # # 
# # # # # # # # . . # # # # # 
# # # # . . . . . . . # # # # 
# # # . . . . . . . . . # # # 
# # # . . # # # . . . . . # # 
# # . . . . . . . . . . . . # 
# # . . . . . . . . # # . # # 
# # . . . # # . . # # # # # # 
# # . . . # # . . . # # # # # 
# # . . # # # # . . . # # # # 
# # # . # # # # . . . . # # # 
# # # # # # # # # . . . # # # 
# # # # # # # # # # # # # # # 
# # # # # # # # # # # # # # # 

# # # # # # # # # # # # # # # 
# # # # # # # # # # # # # # # 
# # # # # # # # # # # # # # # 
# # # # # # # # # # . # # # # 
# # # # # # # # # . . . # # # 
# # # # # # # # . . . . # # # 
# # # # # # . . . . . . . # # 
# # # # # . . . . . . . . # # 
# # # . . . . . . . . . . # # 
# # . . . # . . . . . . . # # 
# # . . # # . . # # . . . # # 
# # . . . . . # # # . . . # # 
# . . . . . # # # # # . . # # 
# . . . . # # # # # # . . # # 
# . . . # # # # # # # . . # # 
# # # # # # # # # # . . # # # 
# # # # # # # # # . . # # # # 
# # # # # # # # . . . # # # # 
# # # # . . . . . . . # # # # 
# # # . . . . . . . . . # # # 
# # # . . . . . . . . . . # # 
# # . . . . . . . . . . . # # 
# # . . . . . . . . # # # # # 
# # . . . . . . . . # # # # # 
# # . . . # # . . . # # # # # 
# # . . # # # # . . . # # # # 
# # # # # # # # . . . . # # # 
# # # # # # # # # . . # # # # 
# # # # # # # # # # # # # # # 
# # # # # # # # # # # # # # # 

# # # # # # # # # # # # # # # 
# # # # # # # # # # # # # # # 
# # # # # # # # # # # # # # # 
# # # # # # # # # # # # # # # 
# # # # # # # # # . . . # # # 
# # # # # # # # . . . . # # # 
# # # # # # . . . . . . . # # 
# # # # # . . . # # # . . # # 
# # # . . . . . # # # . . # # 
# # . . . . . . . . . . . # # 
# # . . . . . . # . . . . # # 
# # . . . . . # # # . . . # # 
# . . . . . # # # # # . . # # 
# . . . . # # # # # # . . # # 
# # . . # # # # # # # . . # # 
# # # # # # # # # # . . # # # 
# # # # # # # # # . . # # # # 
# # # # # # # # . . . # # # # 
# # # # . . . . . . . # # # # 
# # # . . . . . # . . . # # # 
# # # . . # # # # . . . . # # 
# # . . # # # # # . . . # # # 
# # . . . # # # . . . # # # # 
# # . . . . . . . . # # # # # 
# # . . . # # . . . # # # # # 
# # # . # # # # . . . # # # # 
# # # # # # # # . . . # # # # 
# # # # # # # # # . . # # # # 
# # # # # # # # # # # # # # # 
# # # # # # # # # # # # # # # 

# # # # # # # # # # # # # # # 
# # # # # # # # # # # # # # # 
# # # # # # # # # # # # # # # 
# # # # # # # # # # # # # # # 
# # # # # # # # # . . # # # # 
# # # # # # # # . . . . # # # 
# # # # # # . . . . . . . # # 
# # # # # . . . . # . . . # # 
# # # . . . . . . # . . . # # 
# # . . . . . . . . . . . # # 
# # . . . . . . . . . . . # # 
# # . . . . . # # # . . . # # 
# . . . . . # # # # # . . # # 
# . . . . # # # # # # . . # # 
# # . . # # # # # # # . . # # 
# # # # # # # # # # . . # # # 
# # # # # # # # # . . # # # # 
# # # # # # # # . . . # # # # 
# # # # . . . . . . . # # # # 
# # # . . . . . . . . . # # # 
# # # . . # # # # . . . # # # 
# # . . . # # # # . . . # # # 
# # . . . # # # . . . # # # # 
# # . . . . # . . . # # # # # 
# # . . . # # . . . # # # # # 
# # # # # # # # . . . # # # # 
# # # # # # # # . . . # # # # 
# # # # # # # # # . # # # # # 
# # # # # # # # # # # # # # # 
# # # # # # # # # # # # # # # 

# # # # # # # # # # # # # # # 
# # # # # # # # # # # # # # # 
# # # # # # # # # # # # # # # 
# # # # # # # # # # # # # # # 
# # # # # # # # # . . # # # # 
# # # # # # # # . . . . # # # 
# # # # # # . . . . . . . # # 
# # # # # . . . . . . . . # # 
# # # . . . . . . . . . . # # 
# # . . . . . . . . . . . # # 
# # . . . . . . . . . . . # # 
# # . . . . . # # # . . . # # 
# . . . . . # # # # # . . # # 
# . . . . # # # # # # . . # # 
# # . . # # # # # # # . . # # 
# # # # # # # # # # . . # # # 
# # # # # # # # # . . # # # # 
# # # # # # # # . . . # # # # 
# # # # . . . . . . . # # # # 
# # # . . . . . . . . . # # # 
# # # . . . # # . . . . # # # 
# # . . . # # # # . . . # # # 
# # . . . # # # . . . # # # # 
# # . . . # # . . . # # # # # 
# # # . . # # . . . # # # # # 
# # # # # # # # . . . # # # # 
# # # # # # # # . . . # # # # 
# # # # # # # # # # # # # # # 
# # # # # # # # # # # # # # # 
# # # # # # # # # # # # # # # 

# # # # # # # # # # # # # # # 
# # # # # # # # # # # # # # # 
# # # # # # # # # # # # # # # 
# # # # # # # # # # # # # # # 
# # # # # # # # # . . # # # # 
# # # # # # # # . . . . # # # 
# # # # # # . . . . . . . # # 
# # # # # . . . . . . . . # # 
# # # . . . . . . . . . . # # 
# # . . . . . . . . . . . # # 
# # . . . . . . . . . . . # # 
# # . . . . . # # # . . . # # 
# . . . . . # # # # # . . # # 
# . . . . # # # # # # . . # # 
# # . . # # # # # # # . . # # 
# # # # # # # # # # . . # # # 
# # # # # # # # # . . # # # # 
# # # # # # # # . . . # # # # 
# # # # . . . . . . . # # # # 
# # # . . . . . . . . . # # # 
# # # . . . # # . . . . # # # 
# # . . . # # # . . . . # # # 
# # . . . # # # . . . # # # # 
# # . . . # # . . . # # # # # 
# # # . # # # . . . # # # # # 
# # # # # # # # . . . # # # # 
# # # # # # # # # . # # # # # 
# # # # # # # # # # # # # # # 
# # # # # # # # # # # # # # # 
# # # # # # # # # # # # # # # 

